{
	"#0000ff": "Hidrósfera",
	"#001a00": "#001a00",
	"#002600": "#002600",
	"#003300": "#003300",
	"#004d00": "#004d00",
	"#005900": "#005900",
	"#007300": "#007300",
	"#007f00": "#007f00",
	"#008c00": "#008c00",
	"#009900": "#009900",
	"#00a600": "#00a600",
	"#00bf00": "#00bf00",
	"#00cc00": "#00cc00",
	"#00d900": "#00d900",
	"#00e500": "#00e500",
	"#00ffff": "Minoica",
	"#ff0000": "Médica",
	"#ff00ff": "Cicládica",
	"#ffff00": "Micénica"
}